24
22
000002222222200000000000
000000000000000000001111
000000000000000000002000
000000000000000000002000
000000000000000000002000
000111111111100000000000
000000000000000000000000
000000000000000000000000
000000000000000000000000
000000000000100000000000
101000100110211000000000
000000000000000000001111
000000000000000000002222
000000000000000000002222
000000000000000000002222
000000000000000000002222
000000000001100000002222
000000000002200000002222
000000000002200000002222
000000000002200000002222
000000000002200000002222
111100011112200000002222
2
694
299
0
-30
0.8
-20
619
0
-30
14
6
250
1211
0
835
1211
0
1070
1211
0
1080
295
4.71238898
1080
950
4.71238898
1080
1155
4.71238898
2
1000
300
1050
1000
2
710
224
0
80
544
1
50
1250