24
22
000002222222200000000000
000000000000000000001111
000000000000000000002000
000000000000000000002000
000000000000000000002000
000111111111100000000000
000000000000000000000000
000000000000000000000000
000000000000000000000000
000000000000100000000000
101000100110211000000000
000000000000000000001111
000000000000000000002222
000000000000000000002222
000000000000000000002222
000000000000000000002222
000000000001100000002222
000000000002200000002222
000000000002200000002222
000000000002200000002222
000000000002200000002222
111100011112200000002222
222200022222200000002222